1111111111111111111111111111
1000000000000000000000000001
100C0C00CCC000C0C00CC0000001
100C0C0000C000C0C000C0000001
100CCCC00CC000CCCC0CC000P001
10000C000C000000C00C00000001
1E000C000CCC0000C00CC0000001
1111111111111111111111111111
