111111111111111111111111111111
1P00000C000000000C000000000001
111110111101111011111011101111
100000000001000010000000000001
101111011111011110111101111101
1000000100000000000000100C0001
111111010111111111110110111111
1C0000010000000000000100000001
111110111011101111101111111101
100010000000101000000000001001
101011111111101111111101101011
1C100C000001000000001001000001
111111011100011111101111101111
1C00000100010C0000000100000001
1E00C0000001100010000001101C01
111111111111111111111111111111
