1111111111111111111111111111
1000000000000000000000000001
10000000001000000000000000E1
1000000000100000C00000000001
1000000000100000000000000P01
1000000000100000000000000001
1111111111111111111111111111
