1111111111111111111111111111
100000C000000000C00000000001
10000000001000000000000000E1
100C000000100000C00000000001
1000000000100000000000000P01
100000E00010000000C000000001
1111111111111111111111111111
