11111
11P11
11E11
11C11
11111
