11111
10P01
10E01
10C01
11111
